NO ./textures/north.xpm
SO ./textures/south.xpm
WE ./textures/west.xpm
EA ./textures/east.xpm

F 220,100,0
C 225,30,0

1111111
1101001
100000111111
10E000000001
100000000001
111110000001
111111101111
111111101111
111111101111
111111101111
100000001111
111111111111
