NO textures/test/north.xpm
SO textures/test/south.xpm
WE textures/test/west.xpm
EA textures/test/east.xpm

F 20,20,255
C 200,200,0

111111111111111111111
1W0000000000000000001
111111111111111111111
