NO ./textures/north.xpm
SO ./textures/south.xpm


F 160,82,45
C 135,206,235

WE ./textures/west.xpm
EA ./textures/east.xpm

1111111111
1000000001
10N0000001
1000000001
1111111111
