NO ./textures/north.xpm
SO ./textures/south.xpm
WE ./textures/west.xpm
EA ./textures/east.xpm

F 160,82,45
C 135,206,235

1111111111
1E00000001
1011111101
1010000101
1010110101
1010000101
1011111101
1000000001
1111111111

