NO ./textures/north.xpm
SO ./textures/south.xpm
WE ./textures/west.xpm
EA ./textures/east.xpm

F 160,82,45
C 135,206,235

1111111111
1000000001
10N0000001
10000 0001
1111111111
