NO ./textures/north.xpm
SO ./textures/south.xpm
WE ./textures/west.xpm
EA ./textures/east.xpm

F 160,82,45
C 135,206,235

111111
N0001
100001
111111